task4
An Interactive Fiction by Matthew Gotte
Release 1 / Serial number 220814 / Inform 7 build 6M62 (I6/v6.33 lib 6/12N) SD

Room A
You are in Room A and see two boxes. Room B is south

You can see Box One with a South African flag on it

You can see Box Two with a French flag on it

>go to Room A
You can't see any such thing.

* * *

task4
An Interactive Fiction by Matthew Gotte
Release 1 / Serial number 220814 / Inform 7 build 6M62 (I6/v6.33 lib 6/12N) SD

Room A
You are in Room A and see two boxes. Room B is south

You can see Box One with a South African flag on it

You can see Box Two with a French flag on it

>Go to Room B
You can't see any such thing.

>Room B
That's not a verb I recognise.

>go to room b
You can't see any such thing.

* * *

task4
An Interactive Fiction by Matthew Gotte
Release 1 / Serial number 220814 / Inform 7 build 6M62 (I6/v6.33 lib 6/12N) SD

Room A
You are in Room A and see two boxes. Room B is south

You can see Box One with a South African flag on it

You can see Box Two with a French flag on it

>go south
Room B
You are in Room B, Room A is north. You see an aquarium which contains Paul the Octopus.  Thow both boxes from Room A in then tell Paul the Octopus which box to open

>go north
Room A
You are in Room A and see two boxes. Room B is south

You can see Box One with a South African flag on it

You can see Box Two with a South African flag on it

>clear
What do you want to clear?

>everyting
You can't see any such thing.

>cls
That's not a verb I recognise.

>quit
Are you sure you want to quit?

* * *

>go south
Room B
You are in Room B, Room A is north. You see an aquarium which contains Paul the Octopus.  Thow both boxes from Room A in then tell Paul the Octopus which box to open

>what is in the aquarium
That's not a verb I recognise.

>open the aquairum
You can't see any such thing.

* * *

>go south
Room B
You are in Room B, Room A is north. You see an aquarium which contains Paul the Octopus.  Thow both boxes from Room A in then tell Paul the Octopus which box to open

>open the aquarium
You can't see any such thing.

>what is in The Aquarium
That's not a verb I recognise.

>The Aquarium
That's not a verb I recognise.

>open The Aquarium
You can't see any such thing.

* * *

task4
An Interactive Fiction by Matthew Gotte
Release 1 / Serial number 220814 / Inform 7 build 6M62 (I6/v6.33 lib 6/12N) SD

Room A
You are in Room A and see two boxes. Room B is south

You can see Box One with a South African flag on it

You can see Box Two with a French flag on it

>go right
You can't see any such thing.

* * *

task4
An Interactive Fiction by Matthew Gotte
Release 1 / Serial number 220814 / Inform 7 build 6M62 (I6/v6.33 lib 6/12N) SD

Room A
You are in Room A and see two boxes. Room B is south

You can see Box One with a South African flag on it

You can see Box Two with a French flag on it

>pick up Box One
Taken.

Go south to Room B

>go south
Room B
You are in Room B, Room A is north. You see an aquarium which contains Paul the Octopus.  place both boxes from Room A in then tell Paul the Octopus which box to open

You can see an Aquarium (in which is Paul the Octopus) here.

>place Box One into the aquarium
That's not a verb I recognise.

>put box one in the awuarium
I only understood you as far as wanting to put Box One in Paul the Octopus.

>put box one in the aquarium
You put Box One into the Aquarium.

Waiting for Box Two...

* * *

>go south
Room B
You are in Room B, Room A is north. You see an aquarium which contains Paul the Octopus.  place both boxes from Room A in then tell Paul the Octopus which box to open

You can see an Aquarium (in which is Paul the Octopus) here.

>place box one in the aquarium
That's not a verb I recognise.

>Put Box One into the Aquarium
You put Box One into the Aquarium.

Waiting for Box Two...

* * *

task4
An Interactive Fiction by Matthew Gotte
Release 1 / Serial number 220814 / Inform 7 build 6M62 (I6/v6.33 lib 6/12N) SD

Room A
You are in Room A and see two boxes. Room B is south

You can see Box One with a South African flag on it

You can see Box Two with a French flag on it

>go to Room B
You can't see any such thing.

>go suoth
You can't see any such thing.

>go south
Room B
Room B contains an aquarium, which in turn, contains Paul the Octopus

>go north
Room A
You are in Room A and see two boxes. Room B is south

You can see Box One with a South African flag on it

You can see Box Two with a South African flag on it

* * *

task4
An Interactive Fiction by Matthew Gotte
Release 1 / Serial number 220814 / Inform 7 build 6M62 (I6/v6.33 lib 6/12N) SD

Room A
You are in Room A and see two boxes. Room B is south

You can see Box One with a South African flag on it

You can see Box Two with a French flag on it

>open box a
Which do you mean, Box One or Box Two?

>open box one
It isn't something you can open.

* * *

task4
An Interactive Fiction by Matthew Gotte
Release 1 / Serial number 220814 / Inform 7 build 6M62 (I6/v6.33 lib 6/12N) SD

Room A
You are in Room A and see two boxes. Room B is south

You can see Box One with a South African flag on it

You can see Box Two with a French flag on it

>open box one
It isn't something you can open.

* * *

task4
An Interactive Fiction by Matthew Gotte
Release 1 / Serial number 220814 / Inform 7 build 6M62 (I6/v6.33 lib 6/12N) SD

Room A
You are in Room A and see two boxes. Room B is south

You can see Box One with a South African flag on it

You can see Box Two with a French flag on it

>open Box One
You open Box One, revealing a banana.

>clear
What do you want to clear?

>nevermind
You can't see any such thing.

* * *

task4
An Interactive Fiction by Matthew Gotte
Release 1 / Serial number 220814 / Inform 7 build 6M62 (I6/v6.33 lib 6/12N) SD

Room A
You are in Room A and see two boxes. Room B is south

You can see Box One with a South African flag on it

You can see Box Two with a French flag on it

>pick up box one
Taken.

Go south to Room B
Paul the Octopus opened Box One, France will win!

>go south
Room B
You are in Room B, Room A is north. You see an aquarium which contains Paul the Octopus.  place both boxes from Room A in then tell Paul the Octopus which box to open

You can see an Aquarium (in which is Paul the Octopus) here.

>put box one into the aquarium
You put Box One into the Aquarium.

Waiting for Box Two...

>go norht
You can't see any such thing.

>go north
Room A
You are in Room A and see two boxes. Room B is south

You can see Box Two with a French flag on it

Waiting for Box Two...

>pick up box two
Taken.

Go south to Room B
Waiting for Box Two...

>go south
Room B
You are in Room B, Room A is north. You see an aquarium which contains Paul the Octopus.  place both boxes from Room A in then tell Paul the Octopus which box to open

You can see an Aquarium (in which are Box One (closed) and Paul the Octopus) here.

Waiting for Box Two...

>put box two into the aquarium
You put Box Two into the Aquarium.

Paul the Octopus opened Box One, South France will win!

* * *

>pick up box one
Taken.

Go south to Room B
Paul the Octopus opened Box One, France will win!

>pick up box two
Taken.

Go south to Room B

>go south
Room B
You are in Room B, Room A is north. You see an aquarium which contains Paul the Octopus.  place both boxes from Room A in then tell Paul the Octopus which box to open

You can see an Aquarium (in which is Paul the Octopus) here.

>place box one into the aquarium
That's not a verb I recognise.

>put box one into the aquarium
You put Box One into the Aquarium.

Waiting for Box Two... It is still in Room B

>put box two into the aquarium
You put Box Two into the Aquarium.

Paul the Octopus opened Box One, South France will win!

>put box two into the aquarium
(first taking Box Two)
You put Box Two into the Aquarium.

Paul the Octopus opened Box One, South France will win!

>put box two into the aquarium
(first taking Box Two)
You put Box Two into the Aquarium.

Paul the Octopus opened Box One, South France will win!

* * *

>pick up box one
Taken.

Go south to Room B
Paul the Octopus opened Box One, France will win!

>pick up box one
You already have that.

Go south to Room B
Paul the Octopus opened Box One, France will win!

>pick up box one
You already have that.

Go south to Room B
Paul the Octopus opened Box One, France will win!

* * *

task4
An Interactive Fiction by Matthew Gotte
Release 1 / Serial number 220814 / Inform 7 build 6M62 (I6/v6.33 lib 6/12N) SD

Room A
You are in Room A and see two boxes. Room B is south

You can see Box One with a South African flag on it

You can see Box Two with a French flag on it

I beg your pardon?

I beg your pardon?